11111111111111111
17000000000000001
10101010101010101
10222222222222221
10101010101010101
10000000000000001
10000000000000001
10000000000000001
10101010101010101
10101010101010101
10101510100101041
10000000000000061
11111111111111111
