11111111111111111
17000300000000301
10000000000000001
10000000000000001
10000000000000001
10000000000000001
13000000000000031
10000000000000001
10000000000000001
10000000000000001
10000000000000001
10030000000030061
11111111111111111
