11111111111111111
19022222222222001
19121212121212101
10222222222222221
10101010101010101
10000000000000001
10101310101710101
10000000000000001
10101410101010101
10000000000000001
10101510168010101
10000000080080001
11111111111811111