11111111111111111
10222222222220010
11212121212121010
10222222222222221
10101010101010101
10000000000000001
10101310101010101
10000000000000001
10101410101010101
10000000000000001
10101510100101041
10000000000000001
11111111111111111
