11111111111111111
17222222222220051
10101010101010121
10222222222222221
10101010101010101
10000000000000001
10101310101010101
10000000000000001
10101410101010101
10000000000000001
10101510100101041
10000000000000061
11111111111111111
