11111111111111111
17000000000000001
10101010101010101
12222222222222221
12121212121212121
12121212121212121
13343333433334331
12121212121212121
12121212121212121
12222222222222221
10101010101010101
10000000000000061
11111111111111111
