11111111111111111
12222222222222221
12151212121214121
12222222422222221
12101212121210121
12070223032206021
12101212121210121
13222222222222231
12121212121212121
12242222322225221
12121212121212121
12222222222222221
11111111111111111
