11111111111111111
10022222222222001
10121212121212101
10222222222222221
10101010101010101
10000000000000001
10101310101010101
10000000000000001
10101410101010101
10000500060000001
10101010101010101
10000000000000701
11111111111111111