11111111111111111
10222222222220001
10121212121212101
10222222222222221
10101010101010101
10000323450120001
10100054323450101
10000333333330001
10101410101010101
10000500000000001
10101010101010101
10000000000000001
11111111111111111
