11111111111111111
10222222222220001
12121212121212101
10222222222222221
10171111121110101
10002323452226001
10100254323250101
10000332332332021
12101111111110101
10022520022200001
10101210101010101
10000202020022021
11111111111111111
