11111111111111111
10222222222220001
10121212121212101
10222222222222221
10171010121010101
10002323452226001
10100254323250101
10000332332330001
10101412101210101
10002520020200001
10101210101010101
10000202000000001
11111111111111111
