11111111111111111
10022222202222221
10121212121212121
12222022222222221
10161212101010101
10002222203020221
10101212121012101
10204222020700001
12101212101010101
10220222500222001
10121212101212101
10000222220020001
11111111111111111
