11111111111111111
19022222222222001
10121212121212101
10222222222222221
10101010101010101
10000323456720001
10107654323450101
10000333333330001
10101410101010101
10000500111116001
10101010101010101
10000000000000781
11111111111111111